VVVVVVVVVVVVVVVVVVVVA
VVVVVVVVVVVVVVVVVVVVA
VVVVVVVVVVVVVVVVVVVVA
VVVVVVVVVVVVVVVVVVVVA
VJJBBBBJJVVVVJJBBJJVA
VJF]AA]GJVVVVJFAAGJVA
VEAAAAAANVVVVLAAAADVA
VEAAAAAANVVVVLA]ATDVA
VEAAAAAAJVVVVJHAAIJVA
VEAAAAAADVVVVJJCCJJVA
VEAAAAAADVVVVVVVVVVVA
VJH]AU]IJVVVVVVVVVVVA
VJJCCCCJJVVVVVVVVVVVA
VVVVVVVVVVVVVVVVVVVVA
VVVVVVVVVVVVVVVVVVVVA
AAAAAAAAAAAAAAAAAAAAA