AAAAJJBBBBBBBJJAAAAAA
AAAAJFAAATAAAGJAAAAAA
AAAAEAAAAAAAAADAAAAAA
AAAAEAAAARAAAADAMAMAA
AAAAESAASSSSSSDMAMAMA
AAAAEAAAAAAAAADMAAAMA
AAAAEAAAAAAAAADAMAMAA
AAAAERRRRRRAARDAAMAAA
AAAAEAAAAAAAAADAAAAAA
AAAAEAAAAAAAAADALALAA
AAAAEAAAAAAAAADLALALA
AAAAEAAAAUAAAADLAAALA
AAAAEAAAAAAAAADALALAA
AAAAJHAAAAAAAIJAALAAA
AAAAJJCCCCCCCJJAAAAAA
AAAAAAAAAAAAAAAAAAAAA