AAAAAAAAAAAAAAAAAAAAA
AAAAAAAAAAAAAAAAAAAAA
AAOOOOOOOOOOOOAAAAAAA
AAOF[[[[[[[[GOAAAAAAA
AAO[[[[[[[[[[OAAAAAAA
AAO[[OOOOOO[[OMMMMMAA
AAO[[OF[[GO[[OIHAIHAA
AAO[[O[[[[O[[OGFAGFAA
AAOH\OH\[[O[[OAAAA[AA
OOOOOOOO[[O[[OAAIA[AA
E[[[[[[R[IO[[OAAAAAAA
EU[[[[[[[[R[IOAJJJAAA
E[[[[[[[[[[[[OJAAAJAA
OOOOOOOOOOOOOOAAAAAAA
AAAAAAAAAAAAAAAAAAAAA
AAAAAAAAAAAAAAAAAAAAA