AAAAAJJJBBBBBBJJJAAA
AAAAAJJFAAAAAAGJJAAA
AALAAJFAAAAAAAAGJAAA
AAAAAEAAICCCHAAADAAA
AAAAAETADJJJEAAADAAA
AAAAAJCCJJBBFAAADAAA
AAAAAAAAJFAAAAAIJAAA
AAAAAAAAEAAAAAIJJAAA
AAAAAAAAEAICCCJJJAAA
AAAAAAAAEADAAAAAAAAA
AAAAAAAAEADAAAAAAAAA
AAAAAAAAEUDAAAAAAAAA
AAAAAANAJCJAAAAAAAAA
AAAAAAAAAAAAAAAAAAMA
AAAAAAAAAAAAAAAAAAAA