JJBJJBJJBJJBJJBJJBJJA
BFTGFTGFTGFTGFTGFTGBA
VVVVVVVVVVVVVVVVVVVZA
YVVVVVVVVVVVVVVVVVVVA
VVVVVVVVVVVVVVVVVVVZA
AAAAAAAAAKAAAAAAAAAAA
PPPPPPPPPPPPPPPPPPPPA
PPPPPPPPPPPPPPPPPPPXA
QQQQQQQQQQQQQQQQQQQQA
WPPPPPPPPPPPPPPPPPPPA
PPPPPPPPPPPPPPPPPPPPA
CCCCHAAAAAAAAAAICCCCA
JJJJEAAAUAAAAAADJJJJA
JJJJEAAAAAAAAAADJJJJA
JJJJJCCCCCCCCCCJJJJJA
AAAAAAAAAAAAAAAAAAAAA